13 13 13 13 13 13 13 13 13 13 13 13 13 13 13 13 13 13 13 13 13 13 13 13 13 13 13 13 13 13 13 13 13 13 13 13 13 13 13 13
13 13 13 13 13 13 13 13 13 13 13 13 13 13 13 13 13 13 13 13 13 13 13 13 13 13 13 13 13 13 13 13 13 13 13 13 13 13 13 13
13 13 13 13 13 13 13 13 13 13 13 13 13 13 13 13 13 13 13 13 13 13 13 13 13 13 13 13 13 13 13 13 13 13 13 13 13 13 13 13
13 13 13 13 13 13 13 13 13 13 13 13 13 13 13 13 13 13 13 13 13 13 13 13 13 13 13 13 13 13 13 13 13 13 13 13 13 13 13 13
13 13 13 13 10 10 10 10 10 10 10 10 10 10 10 10 10 10 10 10 10 10 15 10 10 10 10 10 10 10 10 10 10 10 10 10 13 13 13 13
13 13 13 13 10 10 10 10 10 10 10 10 10 10 10 10 10 10 10 10 10 10 15 10 10 10 10 10 10 10 10 10 10 10 10 10 13 13 13 13
13 13 13 13 10 10 10 15 15 15 10 15 10 10 10 10 10 10 10 10 10 10 15 10 10 11 11 11 10 10 11 11 11 10 10 10 13 13 13 13
13 13 13 13 10 10 10 15 10 10 10 15 10 26 15 10 10 15 15 15 10 10 15 10 10 11 12 22 12 12 12 12 11 10 10 10 13 13 13 13
13 13 13 13 10 10 15 15 10 10 10 15 15 15 15 10 10 15 10 15 10 10 15 10 10 11 12 12 12 12 23 12 11 10 15 15 13 13 13 13
13 13 13 13 10 10 15 10 10 10 10 10 10 10 10 10 10 10 10 15 15 15 15 10 10 11 12 20 12 12 12 28 11 10 10 15 13 13 13 13
13 13 13 13 10 10 15 10 10 11 11 11 11 11 11 11 11 10 10 10 10 10 10 10 10 11 11 11 11 11 11 11 11 10 10 15 13 13 13 13
13 13 13 13 10 10 10 10 10 11 12 12 28 12 12 12 11 10 10 15 15 15 10 10 10 10 10 10 10 10 10 10 10 10 15 15 13 13 13 13
13 13 13 13 10 10 10 25 10 11 12 12 12 12 22 12 11 10 10 15 27 15 10 10 15 10 10 15 15 15 15 15 10 10 15 10 13 13 13 13
13 13 13 13 10 15 15 15 15 11 12 20 12 12 12 12 11 10 10 15 10 15 10 10 15 10 10 15 10 10 10 10 10 10 15 10 13 13 13 13
13 13 13 13 10 10 10 10 10 11 11 11 10 10 11 11 11 10 10 15 10 15 15 15 15 10 10 15 10 10 10 10 10 15 15 10 13 13 13 13
13 13 13 13 10 10 10 10 10 10 10 10 10 10 10 10 10 10 10 15 10 10 10 15 10 10 10 15 25 10 10 10 10 15 10 10 13 13 13 13
13 13 13 13 10 10 15 10 10 10 10 10 10 10 10 10 10 10 10 10 10 10 10 15 15 15 10 15 15 15 15 15 10 15 10 10 13 13 13 13
13 13 13 13 10 10 15 10 10 10 10 15 15 15 15 10 10 10 10 10 10 10 10 10 15 10 10 10 10 15 10 10 10 10 10 10 13 13 13 13
13 13 13 13 10 10 15 10 10 10 10 10 10 10 15 10 10 11 11 11 11 11 11 10 10 10 10 10 10 15 10 10 10 10 10 10 13 13 13 13
13 13 13 13 10 10 15 15 15 15 15 10 10 10 15 10 10 11 20 12 12 21 11 10 10 15 15 15 10 10 10 15 15 15 10 10 13 13 13 13
13 13 13 13 10 10 15 27 10 10 10 10 10 10 15 10 10 11 11 24 12 11 11 10 10 15 10 10 10 10 10 10 10 10 10 10 13 13 13 13
13 13 13 13 10 10 10 10 10 10 10 10 10 10 10 10 10 15 10 10 10 10 10 10 10 15 15 15 15 15 15 15 10 10 10 10 13 13 13 13
13 13 13 13 10 10 10 10 15 15 15 15 10 10 10 10 10 15 10 10 10 10 10 10 10 10 10 10 10 10 10 15 10 10 10 10 13 13 13 13
13 13 13 13 10 10 10 10 15 10 10 10 10 10 15 10 10 15 10 10 10 15 15 15 15 15 15 15 15 10 10 15 10 10 10 10 13 13 13 13
13 13 13 13 10 10 10 10 15 10 10 10 10 10 15 15 15 15 10 10 10 10 10 10 10 15 10 10 15 10 10 15 10 10 10 10 13 13 13 13
13 13 13 13 10 10 10 15 15 10 10 15 15 29 10 10 10 10 10 15 15 15 10 10 10 15 10 10 15 10 10 15 15 15 10 10 13 13 13 13
13 13 13 13 10 10 10 10 10 10 10 10 15 15 10 10 10 10 10 10 10 15 10 15 15 15 10 10 10 10 15 29 10 10 10 10 13 13 13 13
13 13 13 13 10 11 11 11 11 11 10 10 10 10 10 10 15 10 10 10 10 10 10 15 26 10 10 10 10 10 15 10 10 15 10 10 13 13 13 13
13 13 13 13 10 11 12 12 12 11 10 10 10 10 10 10 15 10 10 10 10 10 10 10 10 10 10 10 10 10 10 10 10 15 10 10 13 13 13 13
13 13 13 13 10 11 24 12 28 11 15 15 15 10 10 10 15 15 15 15 15 10 11 11 11 10 10 11 11 11 10 10 15 15 10 10 13 13 13 13
13 13 13 13 10 11 12 12 12 10 10 10 15 10 10 10 10 10 10 10 10 10 11 12 12 12 12 12 28 11 10 10 15 10 10 10 13 13 13 13
13 13 13 13 10 11 12 12 12 10 10 10 15 15 15 10 10 10 10 10 10 10 11 12 20 12 12 12 12 11 10 10 15 10 10 10 13 13 13 13
13 13 13 13 10 11 22 12 20 11 10 10 10 10 10 10 10 10 10 15 10 10 11 12 12 12 12 22 12 11 10 15 27 10 10 10 13 13 13 13
13 13 13 13 10 11 12 12 12 11 10 10 10 10 10 10 10 10 10 15 10 10 11 11 11 11 11 11 11 11 10 15 10 10 10 10 13 13 13 13
13 13 13 13 10 11 11 11 11 11 10 10 10 15 15 15 15 10 10 15 10 10 10 10 10 10 10 10 10 10 10 15 10 10 10 10 13 13 13 13
13 13 13 13 10 10 10 10 10 10 10 10 10 10 10 10 10 10 10 10 10 10 10 10 10 10 15 15 15 15 10 10 10 10 10 10 13 13 13 13
13 13 13 13 13 13 13 13 13 13 13 13 13 13 13 13 13 13 13 13 13 13 13 13 13 13 13 13 13 13 13 13 13 13 13 13 13 13 13 13
13 13 13 13 13 13 13 13 13 13 13 13 13 13 13 13 13 13 13 13 13 13 13 13 13 13 13 13 13 13 13 13 13 13 13 13 13 13 13 13
13 13 13 13 13 13 13 13 13 13 13 13 13 13 13 13 13 13 13 13 13 13 13 13 13 13 13 13 13 13 13 13 13 13 13 13 13 13 13 13
13 13 13 13 13 13 13 13 13 13 13 13 13 13 13 13 13 13 13 13 13 13 13 13 13 13 13 13 13 13 13 13 13 13 13 13 13 13 13 13
#Room1 17 18 22 20
#Room2 9 10 16 14
#Room3 5 27 9 34
#Room4 25 6 32 10
#Room5 22 29 29 33