13 13 13 13 13 13 13 13 13 13 13 13 13 13 13 13 13 13 13 13 13 13 13 13 13 13 13 13 13 13 13 13 13 13 13 13 13 13 13 13
13 13 13 13 13 13 13 13 13 13 13 13 13 13 13 13 13 13 13 13 13 13 13 13 13 13 13 13 13 13 13 13 13 13 13 13 13 13 13 13
13 13 13 13 13 13 13 13 13 13 13 13 13 13 13 13 13 13 13 13 13 13 13 13 13 13 13 13 13 13 13 13 13 13 13 13 13 13 13 13
13 13 13 13 13 13 13 13 13 13 13 13 13 13 13 13 13 13 13 13 13 13 13 13 13 13 13 13 13 13 13 13 13 13 13 13 13 13 13 13
13 13 13 13 10 10 10 10 10 10 10 10 10 10 10 10 10 10 10 10 10 10 14 10 10 10 10 10 10 10 10 10 10 10 10 10 13 13 13 13
13 13 13 13 10 10 10 10 10 10 10 10 10 10 10 10 10 10 10 10 10 10 14 10 10 10 10 10 10 10 10 10 10 10 10 10 13 13 13 13
13 13 13 13 10 10 10 14 14 14 10 14 10 10 10 10 10 10 10 10 10 10 14 10 10 11 11 11 10 10 11 11 11 10 10 10 13 13 13 13
13 13 13 13 10 10 10 14 10 10 10 14 10 10 14 10 10 14 14 14 10 10 14 10 10 11 12 12 12 12 12 12 11 10 10 10 13 13 13 13
13 13 13 13 10 10 14 14 10 10 10 14 14 14 14 10 10 14 10 14 10 10 14 10 10 11 12 12 12 12 12 12 11 10 14 14 13 13 13 13
13 13 13 13 10 10 14 10 10 10 10 10 10 10 10 10 10 10 10 14 14 14 14 10 10 11 12 20 12 12 12 12 11 10 10 14 13 13 13 13
13 13 13 13 10 10 14 10 10 11 11 11 11 11 11 11 11 10 10 10 10 10 10 10 10 11 11 11 11 11 11 11 11 10 10 14 13 13 13 13
13 13 13 13 10 10 10 10 10 11 12 12 12 12 12 12 11 10 10 14 14 14 10 10 10 10 10 10 10 10 10 10 10 10 14 14 13 13 13 13
13 13 13 13 10 10 10 10 10 11 12 12 12 12 12 12 11 10 10 14 10 14 10 10 14 10 10 14 14 14 14 14 10 10 14 10 13 13 13 13
13 13 13 13 10 14 14 14 14 11 12 20 12 12 12 12 11 10 10 14 10 14 10 10 14 10 10 14 10 10 10 10 10 10 14 10 13 13 13 13
13 13 13 13 10 10 10 10 10 11 11 11 10 10 11 11 11 10 10 14 10 14 14 14 14 10 10 14 10 10 10 10 10 14 14 10 13 13 13 13
13 13 13 13 10 10 10 10 10 10 10 10 10 10 10 10 10 10 10 14 10 10 10 14 10 10 10 14 10 10 10 10 10 14 10 10 13 13 13 13
13 13 13 13 10 10 14 10 10 10 10 10 10 10 10 10 10 10 10 10 10 10 10 14 14 14 10 14 14 14 14 14 10 14 10 10 13 13 13 13
13 13 13 13 10 10 14 10 10 10 10 14 14 14 14 10 10 10 10 10 10 10 10 10 14 10 10 10 10 14 10 10 10 10 10 10 13 13 13 13
13 13 13 13 10 10 14 10 10 10 10 10 10 10 14 10 10 11 11 11 11 11 11 10 10 10 10 10 10 14 10 10 10 10 10 10 13 13 13 13
13 13 13 13 10 10 14 14 14 14 14 10 10 10 14 10 10 11 20 12 12 21 11 10 10 14 14 14 10 10 10 14 14 14 10 10 13 13 13 13
13 13 13 13 10 10 14 10 10 10 10 10 10 10 14 10 10 11 11 12 12 11 11 10 10 14 10 10 10 10 10 10 10 10 10 10 13 13 13 13
13 13 13 13 10 10 10 10 10 10 10 10 10 10 10 10 10 14 10 10 10 10 10 10 10 14 14 14 14 14 14 14 10 10 10 10 13 13 13 13
13 13 13 13 10 10 10 10 14 14 14 14 10 10 10 10 10 14 10 10 10 10 10 10 10 10 10 10 10 10 10 14 10 10 10 10 13 13 13 13
13 13 13 13 10 10 10 10 14 10 10 10 10 10 14 10 10 14 10 10 10 14 14 14 14 14 14 14 14 10 10 14 10 10 10 10 13 13 13 13
13 13 13 13 10 10 10 10 14 10 10 10 10 10 14 14 14 14 10 10 10 10 10 10 10 14 10 10 14 10 10 14 10 10 10 10 13 13 13 13
13 13 13 13 10 10 10 14 14 10 10 14 14 10 10 10 10 10 10 14 14 14 10 10 10 14 10 10 14 10 10 14 14 14 10 10 13 13 13 13
13 13 13 13 10 10 10 10 10 10 10 10 14 14 10 10 10 10 10 10 10 14 10 14 14 14 10 10 10 10 14 10 10 10 10 10 13 13 13 13
13 13 13 13 10 11 11 11 11 11 10 10 10 10 10 10 14 10 10 10 10 10 10 14 10 10 10 10 10 10 14 10 10 14 10 10 13 13 13 13
13 13 13 13 10 11 12 12 12 11 10 10 10 10 10 10 14 10 10 10 10 10 10 10 10 10 10 10 10 10 10 10 10 14 10 10 13 13 13 13
13 13 13 13 10 11 12 12 12 11 14 14 14 10 10 10 14 14 14 14 14 10 11 11 11 10 10 11 11 11 10 10 14 14 10 10 13 13 13 13
13 13 13 13 10 11 12 12 12 10 10 10 14 10 10 10 10 10 10 10 10 10 11 12 12 12 12 12 12 11 10 10 14 10 10 10 13 13 13 13
13 13 13 13 10 11 12 12 12 10 10 10 14 14 14 10 10 10 10 10 10 10 11 12 20 12 12 12 12 11 10 10 14 10 10 10 13 13 13 13
13 13 13 13 10 11 12 12 20 11 10 10 10 10 10 10 10 10 10 14 10 10 11 12 12 12 12 12 12 11 10 14 10 10 10 10 13 13 13 13
13 13 13 13 10 11 12 12 12 11 10 10 10 10 10 10 10 10 10 14 10 10 11 11 11 11 11 11 11 11 10 14 10 10 10 10 13 13 13 13
13 13 13 13 10 11 11 11 11 11 10 10 10 14 14 14 14 10 10 14 10 10 10 10 10 10 10 10 10 10 10 14 10 10 10 10 13 13 13 13
13 13 13 13 10 10 10 10 10 10 10 10 10 10 10 10 10 10 10 10 10 10 10 10 10 10 14 14 14 14 10 10 10 10 10 10 13 13 13 13
13 13 13 13 13 13 13 13 13 13 13 13 13 13 13 13 13 13 13 13 13 13 13 13 13 13 13 13 13 13 13 13 13 13 13 13 13 13 13 13
13 13 13 13 13 13 13 13 13 13 13 13 13 13 13 13 13 13 13 13 13 13 13 13 13 13 13 13 13 13 13 13 13 13 13 13 13 13 13 13
13 13 13 13 13 13 13 13 13 13 13 13 13 13 13 13 13 13 13 13 13 13 13 13 13 13 13 13 13 13 13 13 13 13 13 13 13 13 13 13
13 13 13 13 13 13 13 13 13 13 13 13 13 13 13 13 13 13 13 13 13 13 13 13 13 13 13 13 13 13 13 13 13 13 13 13 13 13 13 13
#Room1 17 18 22 20
#Room2 9 10 16 14
#Room3 5 27 9 34
#Room4 25 6 32 10
#Room5 22 29 29 33